    #########                                      
    #       #                                      
    #       #                                      
    #       #                                      
    #       #                                      
    #       #                                      
    ###########                                    
            # #                                    
            # #                                    
            # #                                    
            #######                                
              #   #                                
              #   #     ###########         #######
              #   #     #         #         #     #
              #   #     #         #         #     #
              #   #     #         #         #     #
          ###########   #         #         #     #
          #   #   # #   #         #         #     #
          #   ###########         #         #     #
          #       # #             #         #     #
      ############# #             #   #############
      #   #         #             #   #     #      
###########         #           #############      
#     #             #           # #   #            
#     #             #           # #######          
#     #             #           #     # #          
#     #             #     ^############ #          
#     #             #           #       #          
#     #             #############       #          
#     #                                 #          
#######                                 #          
                                        #          
                                        #          
                                        #          
                                        #          
                                        #          
                            #############          
                            #                      
                            #                      
                            #                      
                            #                      
                            #                      
                            #                      
                            #                      
                            #                      
                            #                      
                            #######                
                                  #                
                                  #                
                                  #                
                                  #                
                                  #                
                                  #                
                                  #                
                                  #                
                                  #                
                                  #   